11111111111
1P000000001
1C111100001
10000100001
11111111111
