1111111111111111111111111111111111
1E0000000000000C00000C000000000001
10100101001000001N1001000000010101
101001001N101010001001000000010101
1P0000001C00C0000000000000000000C1
1000010000001010001111000000011101
1000010000001010000001000000010001
101001111010101000100100N0N0010C01
1011010010101010001011000N00011111
100001C000101010001001000000000001
1000010010101010001000000000000001
1111111111111111111111111111111111
